11111111111111111111111111111111111111111
10000000000000000000000000000000000000001
1E00000000000000C00000C000000000000001001
10111101001000001010010000000101010011101
10111100101010100010010000000101010001001
1P0000000C00C000000000001C100000010001001
10111101001000001010010000000101010001001
10111100101010100010010000000101010001001
10111101001000001010010001000101010001001
10111100101010100010010001000101010001001
101111010010000010100100010001010100010C1
10111101001000001010010001111101010000001
10111101001000001010010000000101010000101
10111101001000001010010001100101010001C11
10111101001000001010010001100101010010011
10111101001000001010011111100101010001011
101111010010000010100100C0000101010001011
1C111100101010100C10010000000101000000001
11111111111111111111111111111111111111111
